%%%%%%%%%%%%%%%%%%%%
%                  %
%                . %
%                  %
%      .o.         %
%     GoPoG      . %
%      .o.         %
%                  %
%                . %
%                  %
%%%%%%%%%%%%%%%%%%%%