%%%%%%%%%
%.oo.oo.%
%GooPooG%
%.oo.oo.%
%%%%%%%%%