%%%%%%%%%%
%P%  %%  %
% %      %
% %%.%%  %
%  G  %  %
%%%%%%%%%%
