%%%%%%%%%
%P     G%
%%%%% %%%
%       %
%%%%%%%%%